%%%%%%%%%%%%%%%%%%%%%%%%%%%%%%%%%%%%
%                               P  %
% %%%%%%%%%%%%%%%%%%%%%%%%%%%%%%%  %
%                               %  %
%%%%%%%%%%%%%%%%%%%%%%%%%%%%%%% %  %
%                               %  %
% %%%%%%%%%%%%%%%%%%%%%%%%%%%%%%%  %
%                               %  %
%%%%%%%%%%%%%%%%%%%%%%%%%%%%%%% %  %
%                               %  %
% %%%%%%%%%%%%%%%%%%%%%%%%%%%%%%%  %
%                               %  %
%%%%%%%%%%%%%%%%%%%%%%%%%%%%%%% %  %
%.                                 %
%%%%%%%%%%%%%%%%%%%%%%%%%%%%%%%%%%%%