%%%%%%%%%%%%%%%%%%%%%%%%%%%%%%%%%%%
%                    P%           %
%                     %           %
%                     %           %
%        %%%%%%%%%%%%%%      %    %
%                            %    %
%                            %    %
%                            %    %
%                            %    %
%                            %    %
%           %%%%%%%%%%%%%%%%%     %
%                      %          %
%                      %          %
%                      %.         %
%%%%%%%%%%%%%%%%%%%%%%%%%%%%%%%%%%%